StringPot	KEYWORD1
read_adc	KEYWORD2
read_length	KEYWORD2
get_adc_value	KEYWORD2
get_length	KEYWORD2
set_adc_min	KEYWORD2
get_adc_min	KEYWORD2
set_adc_max	KEYWORD2
get_adc_max	KEYWORD2
get_length_min	KEYWORD2
get_length_max	KEYWORD2
adc_value_to_length	KEYWORD2
length_to_adc_value	KEYWORD2
Valve	KEYWORD1
enable	KEYWORD2
disable	KEYWORD2
extend_pwm	KEYWORD2
retract_pwm	KEYWORD2
stop	KEYWORD2
extend_ratio	KEYWORD2
retract_ratio	KEYWORD2
get_pwm	KEYWORD2
get_direction	KEYWORD2
legControl	KEYWORD1
angleToSensor	KEYWORD2
sensorToAngle	KEYWORD2
